####################
####__######_____###
##_______###_###_###
##_#####_____###_###
##_######_##_###_###
##_######_##_____###
##_######_#####____#
#########____#####_#
####__######_###___#
##_______###_###_###
##_#####_____###_#_#
##_#############_#_#
##P#########_____#_#
##Z#########___###_#
############_______#
####################