####################
####__######_____###
##_______###_###_###
##_#####_____###_###
##_#############_###
##P#########Z____###
####################