####################
####__######_____###
##_______###_###_###
##_#####_____###_###
##_######_######_###
##_######_###____###
##Z######_#####____#
#########____#####_#
####__######_###___#
##_______###_###_###
##_#####_____###_###
##_#############_###
##P#########_____###
####################