###################
#________________Z#
#_________________#
#_________________#
#_________________#
#_________________#
#_________________#
#_________________#
#_________________#
#P________________#
###################